111111111111111111111111111111
1E0000000000001C10000C000001C1
101C01010001001010100111110001
101001001110100000100100C10101
1P0000000C10C000000001000001C1
111111111111111111111111111111
