1111111111
10010000C1

1000011001
1P0011E001
1111111111
