1111111111111111
10000100000000V1
1010100V01111111
1010010100CCC0E1
1010VV0011111111
10100CV0000000C1
1010VV1111V0V111
1P10000000000001
1111111111111111
