111111111111111111111111111111
1PCCCCCCCCCCCCCCCCCCCCCCCCCCC1
111111C11111V11111111111111111
1VCCCCC1CCC1000000000000000001
11C1111111C1111111111111111111
1CC1CCCCECCCC11111111111111111
1C11C1111C1C11CCCCC11CCCCCC111
1CCCCCC11C1CCCCC11CCCCC11CCCC1
1V1111C1CC11111111111111111111
1CCCCCCCCCCCCCCCCCCCV111111111
111111111111111111111111111111
111111111111111111111111111111
111111111111111111111111111111
111111111111111111111111111111
111111111111111111111111111111
