111111111
1C00E00P1
111111111
